20344200222256
62320222025605
22000344520000
2360022202430
34322000002002
23400000026600
00000370003450
00002220044200
00000000034340
00272300000224
00000000000000
34322000002002
23400000026600
00000370003450
00000000000000
00000000000000
00000000000000
00000000000000
00000000000000
00000000000000
00000000000000
00000000000000
00000000000000
00000000000000
00000000000000
00000000000000
00000000000000
