20365200000334
42320222025405
22000350520000
66001026602430
00002445002002
23400076675003
00000353003450
00003270044200
00000000034340
00244630000224
00000000000000
00000000640000
02500000000000
00000000000000
66001026602430
00002445002002
00000000000000
00000000000000
00000000000000
00000000000000
00000000000000
00000000000000
00000000000000
00000000000000
00000000000000
00000000000000
00000000000000