20344200222256
22320000025405
22000344520000
23442022202430
66722000002002
23400220022200
00000677034500
00002220044200
00000000034340
00222300000224
00000000000000
00000000456600
00000000000000
40000055600000
00000000000000
00000000000000
00000000000235
00000000000000
70000000000000
00000000000000
00000000000000
00000000000000
00000000000000
00000000000000
00000000000000
00000000000000
00000000000000