60333500600065
00050063777600
00006505000006
22320200000300
34322000002002
66704540022200
00000353003450
00005662000200
00000000034340
00222300000224
00000000000000
00005633000000
00000000000000
00000000000224
00000760000000
00000000000000
00000000000000
00000000000000
00000000000000
00000000000000
00000000000000
00000000000000
00000000000000
00000000000000
00000000000000
00000000000000
00000000000000